ALL_Allele	_Allele_key	11 
ALL_CellLine	_CellLine_key	28 
BIB_Refs	_Refs_key	1 
GXD_Antibody	_Antibody_key	6 
GXD_Antigen	_Antigen_key	7 
GXD_Assay	_Assay_key	8 
GXD_Genotype	_Genotype_key	12 
GXD_Structure	_Structure_key	38 
IMG_Image	_Image_key	9 
IMG_ImagePane	_ImagePane_key	35 
MGI_Organism	_Organism_key	20 
MGI_Statistic	_Statistic_key	34 
MLD_Expts	_Expt_key	4 
MRK_Marker	_Marker_key	2 
NOM_Marker	_Nomen_key	21 
PRB_Probe	_Probe_key	3 
PRB_Source	_Source_key	5 
PRB_Strain	_Strain_key	10 
SEQ_Sequence	_Sequence_key	19 
VOC_Evidence	_AnnotEvidence_key	25 
VOC_Term	_Term_key	13 
